1111111111
1001100001
1001011101
1001100101
1000000101
1000000001
10100P1011
1011001011
1000000001
1111111111