1100111111
1111110110
1110111111
0000011110
1111111110
1001010001
10001P0000
1000010001
1111110011
1111001111