1100111111
1111110110
1110111111
0000011110
1111111110
1001000001
10000P0001
1000000001
1111110011
1111001111