1111111111
111111P111
1111111111
1111111111
1111111111
1000000001
1000000001
1000000001
1111111111
1111111111